19 15
1111111111111111111
PEQ5C5C5C5C5C5C5PEQ
6337676767676767633
C5C5C5C5C5C5C5C5C5C
6767676767676767676
C5C5C5CS?@@SC5C5C5C
6767676S;<=S6767676
PEQ5C5CS>1BSC5C5PEQ
6337676S?@AS6767633
C5C5C5CS;<=SC5C5C5C
6767676<111<6767676
C5C5C5C5C5C5C5C5C5C
6767676767676767676
PEQ5C5C5C5C5C5C5PEQ
6337676767676767633
0 0
9 7
6
100
6
8
0 14
18 14
0 10
18 10
1 2
18 2
1 4
18 4
