23 18
81111111111:11111111111
1FEEEEEEEG581FEEEEEEEG5
1DVWWWWWWD411DVWWWWWWD4
1DXUUUUUUHQqPIXUUUUUUD4
1DXUUUUU`63333[UUUUUUD4
1HEG511111181111111FEI4
163R481FEEQ5PEEG511R237
1:16711DSS>1BSSD4186781
111O511HEEQ5PEEI411O511
1FEI411633376333711HEG5
1DVW[UUUU18111UUUUUZWD4
1DXUUUUUU11811UU`UUUUD4
1DXUUUUUUU111UUUUUUU`D4
1HEEEEEEEQ511PEEEEEEEI4
16333333337116333333337
1:118:1181FEG51:1111118
11911::811D4s4111:81911
1111111811HEI4119111181
11 16
11 7
4
200
10
4
2 12
17 12
2 2
17 2
